1111111111111
1E010000000C1
101P101111001
100000E000001
1111111111111