1111111111111
10010000001C1
101P101111001
100000E000001
1111111111111